sm	boolean	false	컴포넌트를 작게 만듭니다.
lg	boolean	false	컴포넌트를 크게 만듭니다.
autofocus	boolean	false	컴포넌트가 생성이 완료된 후, 포커스 강제로 적용합니다.
tabindex	string | number	undefined	탭 이동 순서를 지정합니다.
readonly	boolean	false	읽기전용 모드를 지정합니다.
disabled	boolean	false	선택 및 타겟팅 기능을 제거합니다.
value	string | number	null	컴포넌트의 값을 지정합니다.
prepend-outlined	boolean	false	입력 앞 버튼에 윤곽선이있는 스타일을 적용합니다.
prepend-color	string	primary	입력 앞 버튼의 색상을 지정합니다.
prepend-start	boolean	false	입력 앞 버튼의 버튼을 슬롯 요소보다 앞에 위치합니다.
prepend-mdi	boolean	false	입력 앞 버튼의 텍스트를 지정합니다.
prepend-text	string	undefined	입력 앞 버튼의 텍스트를 지정합니다.
prepend-icon	string	undefined	입력 앞 버튼의 아이콘을 지정합니다. 'prepend-text' 가 우선순위가 더 높습니다.
append-outlined	boolean	false	입력 뒤 버튼에 윤곽선이있는 스타일을 적용합니다.
append-color	string	primary	입력 뒤 버튼의 색상을 지정합니다.
append-end	boolean	false	버튼을 slot 뒤에 위치합니다.
append-mdi	boolean	false	입력 뒤 버튼의 텍스트를 지정합니다.
append-text	string	undefined	입력 뒤 버튼의 텍스트를 지정합니다.
append-icon	string	undefined	입력 뒤 버튼의 아이콘을 지정합니다. 'append-text' 가 우선순위가 더 높습니다.
row	string | number	3	입력 행 높이를 지정합니다. 하나의 행은 글자의 높이를 기준으로 합니다.
